................................
@@@@@@@@@@@@@@@@@@@@@@@@@@@@@@@@
..........@.....................
..........@.....................
................................
..........#.....................
..........#.....................
..........#.....................
..........#.....................
..........#.....................
..........#######...............
................................
..........@.....................
..........@.....................
..........@.....................
..........@.....................
................................
................................
................................
................................
................................