.....................T..........
######....................######
.....#....#..T....##............
.....#....#.......##............
..#..##...........##............
..#.......#.......##########....
..#####...#..........#.....#....
......#...#...T......#.....#....
..#####...#.......##########....
..........#................#....
..........#######..........#....
...........................#....
####......#.......##########....
..........#.......#.............
..........#.......#.............
